1 2 2 2 2 2 2 2 2 2 2 2 2 2 2 2 2 2 2 2 2 2 2 2 2 2 2 1
4 0 0 0 0 0 0 0 0 0 0 0 0 3 4 0 0 0 0 0 0 0 0 0 0 0 0 3
4 0 5 9 9 6 0 5 9 9 9 6 0 3 4 0 5 9 9 9 6 0 5 9 9 6 0 3
4 0 3 0 0 4 0 3 0 0 0 4 0 3 4 0 3 0 0 0 4 0 3 0 0 4 0 3
4 0 7 2 2 8 0 7 2 2 2 8 0 7 8 0 7 2 2 2 8 0 7 2 2 8 0 3
4 0 0 0 0 0 0 0 0 0 0 0 0 0 0 0 0 0 0 0 0 0 0 0 0 0 0 3
4 0 5 9 9 6 0 5 6 0 5 9 9 9 9 9 9 6 0 5 6 0 5 9 9 6 0 3
4 0 7 2 2 8 0 3 4 0 7 2 2 13 14 2 2 8 0 3 4 0 7 2 2 8 0 3
4 0 0 0 0 0 0 3 4 0 0 0 0 3 4 0 0 0 0 3 4 0 0 0 0 0 0 3
4 9 9 9 9 6 0 3 12 9 9 6 0 3 4 0 5 9 9 11 4 0 5 9 9 9 9 3
4 0 0 0 0 4 0 3 14 2 2 8 0 7 8 0 7 2 2 13 4 0 3 0 0 0 0 3
4 0 0 0 0 4 0 3 4 0 0 0 0 0 0 0 0 0 0 3 4 0 3 0 0 0 0 3
4 0 0 0 0 4 0 3 4 0 0 0 0 0 0 0 0 0 0 3 4 0 3 0 0 0 0 3
4 2 2 2 2 8 0 7 8 0 0 0 0 0 0 0 0 0 0 7 8 0 7 2 2 2 2 3
0 0 0 0 0 0 0 0 0 0 0 0 0 0 0 0 0 0 0 0 0 0 0 0 0 0 0 0
4 9 9 9 9 6 0 5 6 0 0 0 0 0 0 0 0 0 0 5 6 0 5 9 9 9 9 3
4 0 0 0 0 4 0 3 4 0 0 0 0 0 0 0 0 0 0 3 4 0 3 0 0 0 0 3
4 0 0 0 0 4 0 3 4 0 0 0 0 0 0 0 0 0 0 3 4 0 3 0 0 0 0 3
4 0 0 0 0 4 0 3 4 0 5 9 9 9 9 9 9 6 0 3 4 0 3 0 0 0 0 3
4 2 2 2 2 8 0 7 8 0 7 2 2 13 14 2 2 8 0 7 8 0 7 2 2 2 2 3
4 0 0 0 0 0 0 0 0 0 0 0 0 3 4 0 0 0 0 0 0 0 0 0 0 0 0 3 
4 0 5 9 9 6 0 5 9 9 9 6 0 3 4 0 5 9 9 9 6 0 5 9 9 6 0 3 
4 0 7 2 13 4 0 7 2 2 2 8 0 7 8 0 7 2 2 2 8 0 3 14 2 8 0 3 
4 0 0 0 3 4 0 0 0 0 0 0 0 0 0 0 0 0 0 0 0 0 3 4 0 0 0 3
4 9 6 0 3 4 0 5 6 0 5 9 9 9 9 9 9 6 0 5 6 0 3 4 0 5 9 3
4 2 8 0 7 8 0 3 4 0 7 2 2 13 14 2 2 8 0 3 4 0 7 8 0 7 2 3
4 0 0 0 0 0 0 3 4 0 0 0 0 3 4 0 0 0 0 3 4 0 0 0 0 0 0 3
4 0 5 9 9 9 9 11 12 9 9 6 0 3 4 0 5 9 9 11 12 9 9 9 9 6 0 3
4 0 7 2 2 2 2 2 2 2 2 8 0 7 8 0 7 2 2 2 2 2 2 2 2 8 0 3
4 0 0 0 0 0 0 0 0 0 0 0 0 0 0 0 0 0 0 0 0 0 0 0 0 0 0 3
2 9 9 9 9 9 9 9 9 9 9 9 9 9 9 9 9 9 9 9 9 9 9 9 9 9 9 1