0 0 0 0 0 0 14 2 2 2 2 2 2 2 2 2 2 2 2 2 2 2 2 2 2 2 2 2 2 2 2 2 2 13 0 0 0 0 0 0
0 0 0 0 0 0 4 0 0 0 0 0 0 0 0 0 0 0 0 3 4 0 0 0 0 0 0 0 0 0 0 0 0 3 0 0 0 0 0 0
0 0 0 0 0 0 4 0 5 9 9 6 0 5 9 9 9 6 0 3 4 0 5 9 9 9 6 0 5 9 9 6 0 3 0 0 0 0 0 0
0 0 0 0 0 0 4 0 3 0 0 4 0 3 0 0 0 4 0 3 4 0 3 0 0 0 4 0 3 0 0 4 0 3 0 0 0 0 0 0
0 0 0 0 0 0 4 0 7 2 2 8 0 7 2 2 2 8 0 7 8 0 7 2 2 2 8 0 7 2 2 8 0 3 0 0 0 0 0 0
0 0 0 0 0 0 4 0 0 0 0 0 0 0 0 0 0 0 0 0 0 0 0 0 0 0 0 0 0 0 0 0 0 3 0 0 0 0 0 0
0 0 0 0 0 0 4 0 5 9 9 6 0 5 6 0 5 9 9 9 9 9 9 6 0 5 6 0 5 9 9 6 0 3 0 0 0 0 0 0
0 0 0 0 0 0 4 0 7 2 2 8 0 3 4 0 7 2 2 13 14 2 2 8 0 3 4 0 7 2 2 8 0 3 0 0 0 0 0 0
0 0 0 0 0 0 4 0 0 0 0 0 0 3 4 0 0 0 0 3 4 0 0 0 0 3 4 0 0 0 0 0 0 3 0 0 0 0 0 0
0 0 0 0 0 0 4 9 9 9 9 6 0 3 12 9 9 6 0 3 4 0 5 9 9 11 4 0 5 9 9 9 9 3 0 0 0 0 0 0
0 0 0 0 0 0 4 0 0 0 0 4 0 3 14 2 2 8 0 7 8 0 7 2 2 13 4 0 3 0 0 0 0 3 0 0 0 0 0 0
0 0 0 0 0 0 4 0 0 0 0 4 0 3 4 0 0 0 0 0 0 0 0 0 0 3 4 0 3 0 0 0 0 3 0 0 0 0 0 0
0 0 0 0 0 0 4 0 0 0 0 4 0 3 4 0 16 17 17 0 10 17 17 15 0 3 4 0 3 0 0 0 0 3 0 0 0 0 0 0
0 0 0 0 0 0 4 2 2 2 2 8 0 7 8 0 16 0 0 0 0 0 0 15 0 7 8 0 7 2 2 2 2 3 0 0 0 0 0 0
0 0 0 0 0 0 1 0 0 0 0 0 0 0 0 0 16 0 0 0 0 0 0 15 0 0 0 0 0 0 0 0 0 1 0 0 0 0 0 0
0 0 0 0 0 0 4 9 9 9 9 6 0 5 6 0 16 0 0 0 0 0 0 15 0 5 6 0 5 9 9 9 9 3 0 0 0 0 0 0
0 0 0 0 0 0 4 0 0 0 0 4 0 3 4 0 16 18 18 18 18 18 18 15 0 3 4 0 3 0 0 0 0 3 0 0 0 0 0 0
0 0 0 0 0 0 4 0 0 0 0 4 0 3 4 0 0 0 0 0 0 0 0 0 0 3 4 0 3 0 0 0 0 3 0 0 0 0 0 0
0 0 0 0 0 0 4 0 0 0 0 4 0 3 4 0 5 9 9 9 9 9 9 6 0 3 4 0 3 0 0 0 0 3 0 0 0 0 0 0
0 0 0 0 0 0 4 2 2 2 2 8 0 7 8 0 7 2 2 13 14 2 2 8 0 7 8 0 7 2 2 2 2 3 0 0 0 0 0 0
0 0 0 0 0 0 4 0 0 0 0 0 0 0 0 0 0 0 0 3 4 0 0 0 0 0 0 0 0 0 0 0 0 3 0 0 0 0 0 0
0 0 0 0 0 0 4 0 5 9 9 6 0 5 9 9 9 6 0 3 4 0 5 9 9 9 6 0 5 9 9 6 0 3 0 0 0 0 0 0
0 0 0 0 0 0 4 0 7 2 13 4 0 7 2 2 2 8 0 7 8 0 7 2 2 2 8 0 3 14 2 8 0 3 0 0 0 0 0 0
0 0 0 0 0 0 4 0 0 0 3 4 0 0 0 0 0 0 0 0 0 0 0 0 0 0 0 0 3 4 0 0 0 3 0 0 0 0 0 0
0 0 0 0 0 0 4 9 6 0 3 4 0 5 6 0 5 9 9 9 9 9 9 6 0 5 6 0 3 4 0 5 9 3 0 0 0 0 0 0
0 0 0 0 0 0 4 2 8 0 7 8 0 3 4 0 7 2 2 13 14 2 2 8 0 3 4 0 7 8 0 7 2 3 0 0 0 0 0 0
0 0 0 0 0 0 4 0 0 0 0 0 0 3 4 0 0 0 0 3 4 0 0 0 0 3 4 0 0 0 0 0 0 3 0 0 0 0 0 0
0 0 0 0 0 0 4 0 5 9 9 9 9 11 12 9 9 6 0 3 4 0 5 9 9 11 12 9 9 9 9 6 0 3 0 0 0 0 0 0
0 0 0 0 0 0 4 0 7 2 2 2 2 2 2 2 2 8 0 7 8 0 7 2 2 2 2 2 2 2 2 8 0 3 0 0 0 0 0 0
0 0 0 0 0 0 4 0 0 0 0 0 0 0 0 0 0 0 0 0 0 0 0 0 0 0 0 0 0 0 0 0 0 3 0 0 0 0 0 0
0 0 0 0 0 0 12 9 9 9 9 9 9 9 9 9 9 9 9 9 9 9 9 9 9 9 9 9 9 9 9 9 9 11 0 0 0 0 0 0
  